WWWWWWWWWWWWWWWWWWWW
W WW W   W   W   WFW
W    W W   W   W   W
W WWWW WWWWWWWWWWWWW
W W  W        WW   W
W WDWWWWWWWWW WW W W
W     E       WW WWW
W WWWWWWW W W W  D W
W   W D   WWW W EW W
W W W W W     WW WWW
W WWWWW WWWWWWW   WW
W     E         W WW
WWWWWWWWWWWWWWWWW  W
WP                 W
WWWWWWWWWWWWWWWWWWWW